000000000000010000000000000
000000000000010000000000000
000000000000010000000000000
000000000000010000000000000
000000000000111000000000000
000000111100000001111000000
010000000000000000000000010
000000000000000000000000000
000100001111222111100001000
000000010000000000010000000
000000100000000000001000000
000000000000000000000000000
111111111111111111111111111